xxxxxxxxxxxxxxxxxxx
x--x-----------x--x
x--x-------e---xe-x
x--x-----------x--x
x-------e-----e---x
x-p-------------e-x 
x-----------e-----x
x--x-----------x--x
x--x-----e-----x-ex
x--x-----------x--x
xxxxxxxxxxxxxxxxxxx
