xxxxxxxxxxxxxxxxxxx
x--x-----------x--x
x--x-------b---xb-x
x--x-----------x--x
x-------b-----b---x
x-p-------------b-x 
x-----------b-----x
x--x-----------x--x
x--x-----b-----x-bx
x--x-----------x--x
xxxxxxxxxxxxxxxxxxx
