xxxxxxxxxxxxxxxxxxxxx
x-------------------x
x---xxxx-------xx---x
x-------------------x 
x------------x------x
x----xx------x------x
x---------p---------x
xxxxxxxxxxxxxxxxxxxxx
